11111111111111111111111111111111111111111111111111111111
11111111111111111111111111111111111111111111111111111111
1111111111XXXXXXXXXXXXXXXXXXXXXXXXXXXXXXXX11111111111111
11111111111111111111111111111111111111111X11111111111111
11111111111111111111111111111111111111111X11111111111111
11111111111111111111111111111111111111111111G11111111111
11111111111111111111111111111111111111111X11111111111111
11111111111111111111111111111111111111111X11111111111111
11111111111111111111111111111111111111111X11111111111111
11111111111111111111111111111111111111111X11111111111111
11111111111111111111111111111111111111111X11111111111111
11111111111111111111111111111111111111111X11111111111111
11111111111111111111111111111111111111111X11111111111111
11111111111111111111111111111111111111111X11111111111111
11111111111111111111111111111111111111111X11111111111111
11111111111111111111111111111111111111111X11111111111111
11111111111111111111111111111111111111111X11111111111111
11111111111111111111111111111111111111111X11111111111111
11111111111111111111111111111111111111111X11111111111111
11111111111111111111111111111111111111111X11111111111111
111111111XXXXXXXXXXXXXXXXXXXXXXXXXXXXXXXXX11111111111111
11111111111111111111111111111111111111111111111111111111
1111S111111111111111111111111111111111111111111111111111
11111111111111111111111111111111111111111111111111111111
11111111111111111111111111111111111111111111111111111111
11111111111111111111111111111111111111111111111111111111
