11999X9999991X911
11999X9999999XXX1
11999X9999999X911
1S999X9999999X9G1
11999X9999999X911
11999X9999999XXXX
11999999999999911
11999999999999911
