11111111111X11111111X1111111X1111
1111111X111X11111111X1111111X1111
1111111X111X11111111X1111111X1111
1111111X111X11111111X1111111X1111
1111111X111X1X111111X1111111X1111
1111111X111X1X111111X1111111X1111
1111111X11111X111111X1111111X1111
11S1111X11111X111111X1111111X1G11
1111111X11111X111111X1111111XXXX1
1111111X11111X111111X111111111111
1111111X11111X111111X111111111111
1111111X11111X111111X111111111111
1111111X11111X111111X111111111111
1111111X11111X111111X111111111111
1111111X11111X111111X111111111111
1111111X11111X1111111111111111111
