119X1X99999911111
11999X99999991111
11999X9999999X911
1S999X9999999X9G1
11999X9999999X911
11999X9999999XXXX
11999999999999911
11999999999999911
