111111111111111111111111111111111
111111111111111111111111111111111
111111XXXXXXXXX111111111111111111
111111XX11111XX111111111111111111
111111XS11111GX111111111111111111
111111XX11111XX111111111111111111
111111XXXXXXXXX111111111111111111
111111111111111111111111111111111
111111111111111111111111111111111
111111111111111111111111111111111
111111111111111111111111111111111
111111111111111111111111111111111
111111111111111111111111111111111
111111111111111111111111111111111
111111111111111111111111111111111
111111111111111111111111111111111
